     #     
    #.#    
   #..##   
  #1....#  
 #.......# 
#....=....#
 #.......# 
  #....2#  
   ##..#   
    #.#    
     #     
*Rhombas