##############
#.........B..#
#....####....#
#..#....#.#..#
#1.#.#=#..#.2#
#..#.B...A#..#
#....##.#....#
#.......A....#
##############
*Inner Chamber