###########################
##.......................##
#.........................#
#...A......B..............#
#.............#.......A...#
#........B................#
#...............B.........#
#1....#......=......#....2#
##.......#................#
#.............A..#........#
#.........B...........B...#
#..............B.....A....#
#....A.................A..#
##.......................##
###########################
*Soccer Field